+- ESRAM_M3: 256 Kb -----------------------------------------------------------+
| +----------------------------------------------------------------------------+
| | SOFTWARE: 254 Kb                                                           |
| +----------------------------------------------------------------------------+
| | DATA: 1 Kb                                                                 |
| +----------------------------------------------------------------------------+
| | TOC: 512 bytes                                                             |
+------------------------------------------------------------------------------+

+- BACKUP_RAM: 512 bytes ------------------------------------------------------+
| +----------------------------------------------------------------------------+
| | FREE: 8 bytes                                                              |
| +----------------------------------------------------------------------------+
| | BOOT_API: 20 bytes                                                         |
| +----------------------------------------------------------------------------+
| | CONTEXT: 32 bytes                                                          |
| +----------------------------------------------------------------------------+
| | CONTEXT: 32 bytes                                                          |
| +----------------------------------------------------------------------------+
| | FREE: 400 bytes                                                            |
| +----------------------------------------------------------------------------+
| | CHECKSUM: 4 bytes                                                          |
| +----------------------------------------------------------------------------+
| | ZQ_CAL: 4 bytes                                                            |
| +----------------------------------------------------------------------------+
| | FREE: 4 bytes                                                              |
| +----------------------------------------------------------------------------+
| | TAG: 4 bytes                                                               |
| +----------------------------------------------------------------------------+
| | RESUME_ADDR: 4 bytes                                                       |
+------------------------------------------------------------------------------+

+- ESRAM_A7: 512 Kb -----------------------------------------------------------+
| +----------------------------------------------------------------------------+
| | TRUSTED_ZONE: 512 Kb                                                       |
| | +--------------------------------------------------------------------------+
| | | BL1_BL2: 123 Kb                                                          |
| | +--------------------------------------------------------------------------+
| | | PROGRAMS: 4 Kb                                                           |
| | +--------------------------------------------------------------------------+
| | | FREE: 432 bytes                                                          |
| | +--------------------------------------------------------------------------+
| | | MAILBOXES: 16 bytes                                                      |
| | +--------------------------------------------------------------------------+
| | | CCC_DATA: 64 bytes                                                       |
| | +--------------------------------------------------------------------------+
| | | IPC: 512 bytes                                                           |
| | +--------------------------------------------------------------------------+
| | | BL32: 256 Kb                                                             |
| | +--------------------------------------------------------------------------+
| | | CODE: 128 Kb                                                             |
| +----------------------------------------------------------------------------+
+------------------------------------------------------------------------------+

+- DDRAM: 512 Mb --------------------------------------------------------------+
| +----------------------------------------------------------------------------+
| | UNTRUSTED_ZONE: 448 Mb                                                     |
| | +--------------------------------------------------------------------------+
| | | SYSTEM_MEM: 307 Mb                                                       |
| | | +------------------------------------------------------------------------+
| | | | MAGIC: 4 Kb                                                            |
| | | +------------------------------------------------------------------------+
| | | | RAMOOPS_MEM: 1024 Kb                                                   |
| | +--------------------------------------------------------------------------+
| | +--------------------------------------------------------------------------+
| | | DATA: 4 Kb                                                               |
| | +--------------------------------------------------------------------------+
| | | MAILBOXES: 4 Kb                                                          |
| | +--------------------------------------------------------------------------+
| | | FREE: 1016 Kb                                                            |
| | +--------------------------------------------------------------------------+
| | | SHMEM: 2 Mb                                                              |
| | +--------------------------------------------------------------------------+
| | | HEAP: 10 Mb                                                              |
| | +--------------------------------------------------------------------------+
| | | GCNANO_POOL: 128 Mb                                                      |
| +----------------------------------------------------------------------------+
| +----------------------------------------------------------------------------+
| | TRUSTED_ZONE: 64 Mb                                                        |
| | +--------------------------------------------------------------------------+
| | | BLOCKDEV_DATA: 512 Kb                                                    |
| | +--------------------------------------------------------------------------+
| | | BL32_SAVED: 512 Kb                                                       |
| | +--------------------------------------------------------------------------+
| | | M3OS_SAVED: 256 Kb                                                       |
| | +--------------------------------------------------------------------------+
| | | TRAINING: 1024 bytes                                                     |
| | +--------------------------------------------------------------------------+
| | | FREE: 46 Mb                                                              |
| | +--------------------------------------------------------------------------+
| | | TEE: 16 Mb                                                               |
| +----------------------------------------------------------------------------+
+------------------------------------------------------------------------------+

